111111
100001
1E0001
111111
