111111111
100000101
10P1001C1
101000001
11110C1C1
1CCCCCE11
111111111